1
1100000000
1100000000
0000000000
0000000011
0000000011
2Solutions
