2
0011111100
0110000110
0110000110
0000000110
0000001110
0000111100
0000110000
0000000000
0000110000
0000110000
Interrogacion
0000000000
0011111000
0111111100
1100100110
1101101110
1111111110
1111111110
1111111110
1010101010
0000000000
Mars
