20
0011111100
0110000110
0110000110
0000000110
0000001110
0000111100
0000110000
0000000000
0000110000
0000110000
Interrogacion
1100110000
0011100000
0110111100
0111111000
0011000000
0111110001
1111111101
1011111110
0011111100
0110111000
Perro
0000000000
0011111000
0111111100
1100100110
1101101110
1111111110
1111111110
1111111110
1010101010
0000000000
Marciano
0011000000
0101000000
1111000000
0011000001
0011100001
0011111111
0011111111
0011111110
0001111100
0000111000
Pato
0000010000
0000100000
0000101100
0000111100
0111111001
0101111110
1101110000
0000010000
0001110000
0001000000
Rana
0100100101
0111110111
0000010010
0000111111
0001111111
0011011111
0111111111
1111100111
1111000011
0110000001
Arce
0000110100
0011000001
0101101000
1001000100
0111000001
0011111111
0111111100
0111111010
0011010011
0001101000
Conejo
0100000000
1100010001
1000011111
1000010101
1111111111
0111111000
0111111110
0100010010
0110011000
1111111111
Gato
1111111110
1000000010
1111111011
0101010001
0001000001
0001100111
0000000100
0011100100
0010000100
0011111100
Cara
0000010000
0000110000
0001110000
0011110000
0111110000
0000010110
1111111100
0111111000
1010101010
0101010101
Barco
0111000010
1101001110
1011101000
1110111011
0011111110
0001110000
0111111110
1101010011
1001011000
0001001000
Pulpo
0011111100
0110000110
1100000011
1011001101
1011001101
1000000001
1001111001
1100110011
0110000110
0011111100
Emoticono
1100110110
1100110111
1100110111
1100000111
1111111111
1000000011
1000000011
1011111011
1000000011
1111111111
Disquete
0000011111
0000011001
0000111101
0000000001
1100101001
1110010101
1100101001
1000010101
1111101001
1100010101
Ducha
0000000011
0001111001
0011111100
0110111110
1111110111
1011111101
1110101111
0101111010
0000110000
1111111111
Arbol
1001111000
0011111101
0011101110
0111000110
0111001100
0111000000
1111100100
1111110001
1111111100
1111111111
Tsunami
0011111100
0111100010
1111000101
1111111111
0001101000
0011100100
0011000100
1011000101
1101111011
1111111111
Boletus
1011111110
1111111111
1100000011
1100000011
0111111110
1111001111
1001001001
1111001111
1111111111
1100000011
Camion
0001111000
0111111110
0100011111
1001011111
1000011111
1000111111
1000110111
0100111110
0110011110
0001111000
Yin Yang
0010000000
0110101000
1011111000
1000001100
1000101010
1110000001
0100000001
0011000001
0010001001
0010101101
Rinoceronte