1
000000000000000
000010000001000
001001000010010
001011111111010
001110111011110
000111111111100
000011111111000
000010000001000
000110000001100
000000000000000
Alien