5
0001111000
0011001100
0110000110
0011001100
0001111000
Cruz
1000000001
1100110011
0111001010
0111001110
0011001100
W
0001111000
0011001100
0110000110
0011001100
0001111000
Cruz
0001111000
0011001100
0110000110
0011001100
0001111000
Cruz
0001111000
0011001100
0110000110
0011001100
0001111000
Cruz