1
1000000001
0000000000
1000000001
0000000000
1000110001
Cruz
