5
10011001
10111101
01011010
01111110
01000010
00111100
11011011
10000001
Alien1
00100100
01111110
11111111
11011011
01111110
01000010
10111101
10000001
Alien2
01000010
00111100
01111110
11011011
11111111
01100110
10100101
10000001
Alien3
01000010
01100110
00100100
00011000
00111100
01011010
11111111
01100110
Alien4
00100100
01000010
00100100
01111110
10011001
11111111
01100110
10100101
Alien4