20
0001111111
0001000001
0001111111
0001000001
0001000001
0001000001
0011111111
0111111111
1111111111
1001000101
1001000101
1001000101
1001000101
1001000101
1000000100
Silla
1100111100
1111111110
1111111111
1100011011
0000011011
0000011000
0000011000
0000011000
0000011000
0000011000
0000011100
0000011100
0000011100
0000011100
0000011100
Martillo
0000001110
0000001110
0000001000
0011111110
0100101001
1000011001
1010010001
1000010001
1111101111
0000010000
0000010000
0000010000
0000010000
0000010000
0000010000
Buzon
0001111000
0001001000
0001001000
0011111100
0111100010
1111110111
0001001000
0001001000
0010100100
0100100010
0100010010
0110110110
0011111100
0001111000
0111111110
Lampara
1111111111
1110011001
1011001101
1001100111
1100110011
1111111111
0001010000
0000100000
0000100000
0001110000
0011111000
0111111100
0111111100
0011111000
0001110000
Medalla
0111000010
1111100100
0111000101
0111001110
1110100000
1010000000
1010000000
1010000000
1101000000
1111000000
0111000000
0011100000
1110100000
1100110000
0110111000
Hombre esperando
0000111110
0001100111
0001001011
0100100001
0100010010
1111011010
0110110111
0011100111
0001101111
0000101111
0000111110
0000011111
0000111111
0000110011
0001100111
Camarero
0001111000
0011101100
0110111100
0100001010
1111111000
1000010000
1111110000
1000100000
1111100000
1001001110
1110010011
0110011001
0111000011
0111111111
0011111110
Serpiente
0111000000
1111100000
0111000000
0011111000
0001111100
0001111100
0011111100
0011011110
0110011110
0111011110
0101011111
0100110111
0100110111
0100110110
0101101110
Señor mayor
0001111010
0010011100
1111111110
0000000110
0000001100
0000011001
0000111110
0000111111
0000111110
0000111101
0000011100
0000001100
0001100100
0001000100
0000111000
Caballito de Mar
0000111000
0000111110
0000100000
0000100000
0001111100
0111110110
0001110110
0001101110
0111111100
0000100000
1111111101
1010110110
0111111100
0111111000
0011110000
Barco
0000000110
0000001101
0000001011
0000001001
0011111100
1111101100
0110011100
0011111000
0011100000
1010100001
1011111011
1000101011
1100100011
1110100011
1110110111
Flamenco
0011000000
0110100000
0011110000
0011110000
0011110000
0110111000
0100011100
1100011110
1100011111
1100001111
1100001101
0100001100
0010011100
0011111110
0001101100
Pinguino
0001000000
0011000000
0110100000
0100010010
0101100101
0101000001
1001100001
1001011010
1100001100
0110000100
1111010110
1101111110
1001100110
1000101011
0000101001
Gato
0110011000
0101100100
0100000010
0010111010
0101000101
1001001001
1010010001
1111111111
0100000010
0111111110
0010000100
0010000100
0011001100
0001001000
0001111000
Helado
0000000110
0000000111
0000000100
0000000110
0000000011
0000000001
0001111011
0011111111
0111111110
0001111110
0000111100
0011101000
0010001110
0110000011
1100000001
Avestruz
0000000100
0100001100
0100001000
0110011000
0011010000
0001111100
0000111110
0000111011
0011111111
0111111110
0111111000
1111111000
1111111000
0111101100
0011110110
Liebre
0010001010
0011000100
0001101000
0000111100
0000011010
0000001111
0000001100
0111111100
0011111110
0111111010
0111001001
1010001001
1010001000
1001001000
1001001000
Reno
0000000100
0000001100
0110111000
1111010100
0000100110
0011000110
0100110010
1101111011
1101011001
1100110110
1000001101
0101101111
0011110110
0011010000
0001100000
Cerezas
0000010000
0000111000
0110111000
1111001110
0110110111
0010110110
1011001000
1011111101
1001111101
1100101011
1110100111
1110101110
0111101110
0000111100
0000010000
Flor