3
0111000000
1101100000
1000111111
1101100101
0111000000
Key
0110000110
1001001001
0101111010
1001001001
0110000110
Bone
0111001110
0101001010
0111001110
1000000001
0111111110
BigFace