1
0001111000
0011001100
0110000110
0011001100
0001111000