1
10000001
00010000
01001000
00001011
00011000
00100000
00111011
00101101