2
0011111100
0110000110
0110000110
0000000110
0000001110
0000111100
0000110000
0000000000
0000110000
0000110000
Interrogacion
0000000000
0011111000
0111111100
1100100110
1101101110
1111111110
1111111110
1111111110
1010101010
0000000000
Mars
0011000000
0101000000
1111000000
0011000001
0011100001
0011111111
0011111111
0011111110
0001111100
0000111000
Pato
0000110100
0011000001
0101101000
1001000100
0111000001
0011111111
0111111100
0111111010
0011010011
0001101000
Conejo
0000010000
0101010000
0111010000
1011000000
0111010000
0011100001
0011111111
0011111100
0011110101
0000110001
NoSe